afr	South Africa
amh	Ethiopia
ara	United Arab Emirates,Bahrain,Algeria,Egypt,Iraq,Jordan,Kuwait,Lebanon,Libya,Morocco,Mauritania,Oman,Palestine,Qatar,Saudi Arabia,Sudan,South Sudan,Syria,Tunisia,Yemen
asm	India
aze	Azerbaijan
bel	Belarus
ben	Bangladesh,India
bos	Bosnia and Herzegovina
bre	France
bul	Bulgaria
cat	Spain
ces	Czechia
cmn	China,China–Hong Kong,China–Macao,China–Taiwan
cym	United Kingdom
dan	Denmark,Faroe Islands,Greenland
deu	Austria,Switzerland,Germany,Liechtenstein
ell	Cyprus,Greece
eng	United Kingdom,United States,Canada,Australia,New Zealand
epo	notfound
est	Estonia
eus	Spain,France
fas	Iran
fin	Finland
fra	Belgium,Canada,Switzerland,France,French Guiana
fry	Netherlands
gla	Ireland
gle	Ireland
glg	Spain,Portugal
guj	India,Pakistan
hau	Nigeria,Niger,Ghana
heb	Israel
hin	India,Nepal
hrv	Croatia
hun	Hungary,Romania
hye	Armenia
ibo	Nigeria,Equatorial Guinea
ind	Indonesia
isl	Iceland
ita	Italy,Malta
jpn	Japan
kan	India
kat	Georgia
kaz	Kazakhstan
khm	Cambodia,Viet Nam,Thailand
kin	Rwanda
kir	Kyrgyzstan
kor	North Korea,South Korea
kur	Turkey,Iraq,Syria
lav	Latvia
lim	Belgium,Germany
lin	Democratic Republic of the Congo,Congo	
lit	Lithuania
mal	India
mar	India
mkd	Macedonia
mlg	Madagascar
mlt	Malta
mon	Mongolia
msa	Malaysia,Indonesia,Brunei
mya	Myanmar
nep	Nepal
nld	Belgium,Caribbean Netherlands,Netherlands,Suriname
nno	Norway
nob	Norway
nor	Norway
oci	Spain,France,Italy
ori	India
orm	Ethiopia,Kenya
pan	India
pol	Poland
por	Angola,Brazil,Cape Verde Islands,Mozambique,Portugal,São Tomé e Príncipe
pus	Pakistan,Afghanistan
ron	Romania,Moldova
rus	Russian Federation
sin	Sri Lanka
slk	Slovakia
slv	Slovenia
sme	Finland
som	Djibouti,Ethiopia,Somalia
spa	Argentina,Bolivia,Belize,Chile,Colombia,Costa Rica,Cuba,Dominican Republic,Ecuador,Spain,Guatemala,Honduras,Mexico,Nicaragua,Panama,Peru,Puerto Rico,Paraguay,El Salvador,Trinidad and Tobago,United States,Uruguay,Venezuela
sqi	Albania
srp	Montenegro,Serbia,
swa	Kenya,Tanzania,Uganda,Rwanda,Burundi
swe	Finland,Sweden
tam	India,Sri Lanka
tat	Russian,Poland
tel	India
tgk	Tajikistan,Uzbekistan,Kazakhstan,Kyrgyzstan
tgl	Philippines
tha	Cambodia,Thailand
tir	Eritrea,Ethiopia
tuk	Turkmenistan,Afghanistan
tur	Cyprus,Turkey
uig	China,Kazakhstan,Mongolia
ukr	Ukraine
urd	Pakistan
uzb	Uzbekistan,Tajikistan,Turkmenistan,Afghanistan,Kazakhstan,Russia
vie	Viet Nam
wln	Belgium
xho	South Africa,Zimbabwe
yid	Germany,Israel
zul	South Africa